R 1000 1000
NO ./texture/wall/4.xpm
SO ./texture/wall/5.xpm
WE ./texture/wall/6.xpm
  
EA ./texture/wall/8.xpm
S ./texture/sprite/1.xpm
F 0,200, 0
C 255, 0, 0

        1111111111111111111111111
        100000000011000N00000000221
        1011000001110000002000001
        1001000000000000000000001
111111111011000001110000000000001
100000000011000001110111111111111
11110111111111011100000010001
11110111111111011101010000001
11000000110111011100000010001
11112000000011111110000001001
   100000001111  1101010010011111111111
111100011101011111110111100000000001111
11110111 1110101 1011110100011111111111
11111111 1111111 111111111111