R 1000 700
    NO ./texture/wall/8.xpm
SO ./texture/wall/bricks.xpm
WE ./texture/wall/cobblestone.xpm
EA ./texture/wall/tile.xpm
S ./texture/sprite/sprite.xpm
F 0,176,145
C 0,191,255
  
   
  
11111111111
1000000002111111111
1020000000000000001
1000000002111000101
10000000001 1000101
1000000000111111201111111111111111111
1000000000200000000000000222200000001
1020001000000000000000000000000000001
1000000000200000000000000222200000001
1111111111111000001111111111111111101
            1000001               101
            1000001               101
            1000001111111111111111101
            1000000000000000000000001
            1000000000000000000000001
1111111111111000000000000000000000001
1000000000000000000012002100000000001
1000000000000000000021001200000000001
1000000000000000000000000000000000001111111111111
1100000000000000000000000000000000000000000000021
 1100E0000000000000000022220000000000000000000001
  11100000000002000000000000000000000000000000021
    111100000000000000000000011111111111111111111
       11111000000000000011111
       1000111110000111111
       1000000011001101
       1000000000000001
       1000000000000001
       1000000000000001
       1111111111111111