R 1200 700
NO ./texture/wall/8.xpm
SO ./texture/wall/1.xpm
WE ./texture/wall/6.xpm
EA ./texture/wall/1.xpm
S ./texture/sprite/pigeons.xpm
F 160,214,10
C 141, 252, 247
1111111111111111111111111
1000000000000000000000001
1002000000000000000000S01
1000000000000000000000001
1000000000000000000000001
1000000111111000000000001
1000000100001000000000001
1000000100001000000000001
1000000100001000000000001
1000000111111000000200001
1000000000000000000000001
1000000000000000000000001
1000000000000000000000001
1111111111111111111111111