R 700 700
    NO ./texture/wall/8.xpm
SO ./texture/sprite/barrel.xpm
WE ./texture/wall/6.xpm

EA ./texture/wall/3.xpm
S ./texture/sprite/barrel.xpm
F 160,214,10
C 141, 252, 247
  
  
    11111111111111111111111111111
1111100000000000000000001
1102000000000200002000001
 111111111111111111111111
1100000000000000000000001
1000000000000000000000001
1000000111111000000000001
1000000100001000000000001
1000000100001000000S00001
1000000100001000000000001
1000000111111000000200001
1000000000000000000000001
1000000000000000000000001
1000000000000000000000001
1111111111111111111111111