R 600 500
NO ./texture/wall/4.xpm
SO ./texture/wall/5.xpm
WE ./texture/wall/6.xpm
EA ./texture/wall/7.xpm
S ./texture/sprite/438.bmp
F 123,145,123
C 104,104,227


        1111111111111111111111111
        1000000000110000000000001
        101100000111000000N000001
        1001000000000000000000001
111111111011000001110000000000001
100000000011000001110111111111111
11110111111111011100000010001
11110111111111011101010010001
11000000110101011100000010001
1000200000000000110000010001
10000000000000001101010010001
1100000111010101111101111000111
11110111 1110101 101111010001
11111111 1111111 111111111111



