R 1280 720
NO ./texture/wall/4.xpm
SO ./texture/wall/5.xpm
WE ./texture/wall/6.xpm
EA ./texture/wall/7.xpm
S ./texture/sprite/438.bmp
F 0,0,255
C 255, 0, 0



1111111111111111111111111
1000000000000000000000001
100000000000000N000000001
1000000000000000000000001
1000000000000000000000001
1000000111111000000000001
10000001    1000000000001
10000001    1000000000001
10000001    1000000000001
1000000111111000000000001
1000000000000000000000001
1000000000000000000000001
1000000000000000000000001
1111111111111111111111111