R 600 400
NO ./texture/wall/4.xpm
SO ./texture/wall/5.xpm
WE ./texture/wall/6.xpm
EA ./texture/wall/1.xpm
S ./texture/sprite/438.bmp
F 0,0,255
C 255, 0, 0



1111111111111111111111111
1000000000000000000000001
1000000000000000000000N01
1000000000000000000000001
1000000000000000000000001
1000000111111000000000001
1000000100001000000000001
1000000100001000000000001
1000000100001000000000001
1000000111111000000000001
1000000000000000000000001
1000000000000000000000001
1000000000000000000000001
1111111111111111111111111